Input:		Output:
4 4
1 1
3
.>>v
.^#v
..#v
...T
....
.v#.
.v#.
.>>T
....
v<#.
v.#.
..>T		1
///////////////////////////////////////////////////////////////


6 7
0 0
1
>.....
......
......
......
......
......
.....T		TRAP
///////////////////////////////////////////////////////////////


6 7
2 2
2
......
......
..>>T.
......
......
......
......
.>>>>v
.^...v
.^<.T<
......
......
......
......		0
///////////////////////////////////////////////////////////////


11 11
5 1
5
...........
...........
.#########.
.>>>>>>>>>v
.^..###...v
.^..###..T<
....###....
...........
.#########.
...........
...........
>>>>>>>>>>v
^.........v
^#########v
^.........v
^...###...v
^<..###..T<
....###....
...........
.#########.
...........
...........
...........
...........
.#########.
.>>>>>>>>v.
.^..###..v.
.^..###..T.
....###....
...........
.#########.
...........
...........
...........
...........
.#########.
.>>>>>>>...
.^..###....
.^..###..T.
....###..^.
...>>>>>>^.
.#########.
...........
...........
...........
...........
.#########.
>>>>>>>>>v.
^...###..v.
^<..###..T.
....###....
...........
.#########.
...........
...........		2
///////////////////////////////////////////////////////////////


19 12
2 4
2
###################
#.................#
#..>>>v......>T...#
#..^..>v.....^<...#
#..^...>v.........#
#..^....v....>v...#
#..^....v....^v...#
#..^...v<....^v...#
#..^..v<.....^v...#
#..^<<<......^<...#
#.................#
###################
###################
#.................#
#...>>>v......>T..#
#...^..>v.....^<..#
#...^...>v........#
#...^....v....>v..#
#...^....v....^v..#
#...^...v<....^v..#
#...^..v<.....^v..#
#...^<<<......^<..#
#.................#
###################		TRAP
///////////////////////////////////////////////////////////////


19 19
0 9
6
#########v#########
##...............##
#........#........#
#....##..#..##....#
#....##..#..##....#
...####..#..####...
...####..#..####...
#........#........#
#.#............#..#
#.#..###.#.###.#..#
#.#............#..#
#.......###.......#
.......#####.......
..#...#######...#..
#..#...#####...#..#
##..#...###...#..##
###..#...#...#..###
####.....T.....####
###################
#########v#########
##.......>>v.....##
#........#.v......#
#....##..#.v##....#
#....##..#.v##....#
...####..#v<####...
...####..#>v####...
#........#.>>>>>>v#
#.#............#.v#
#.#..###.#.###.#.v#
#.#............#.v#
#.......###......v#
.......#####..v<<<.
..#...#######v<.#..
#..#...#####v<.#..#
##..#...###v<.#..##
###..#...#v<.#..###
####.....T<....####
###################
#########v#########
##......v>>>>>>>v##
#.......v#......>v#
#....##.v#..##...v#
#....##.v#..##...v#
...####.v#..####.>>
...####.v#..####...
#...v<<<v#........#
#.#.>^..v......#..#
#.#..###v#.###.#..#
#.#....v<......#..#
#.....v<###.......#
.....v<#####.......
..#..v#######...#..
#..#.>v#####...#..#
##..#.>v###...#..##
###..#.>v#...#..###
####....>T.....####
###################
#########v#########
##......v<>>>>>>v##
#.......v#......>v#
#....##.v#..##...v#
#....##.v#..##...v#
...####.v#..####.>>
...####.v#..####...
#...v<<<v#........#
#.#.>^..v......#..#
#.#..###v#.###.#..#
#.#....v<......#..#
#.....v<###.......#
.....v<#####.......
..#..v#######...#..
#..#.>v#####...#..#
##..#.>v###...#..##
###..#.>v#...#..###
####....>T.....####
###################
#########v#########
##.......>>>>>>>v##
#........#......>v#
#....##..#..##...v#
#....##..#..##...v#
...####..#..####.>v
...####..#..####.v<
#........#.......v#
#.#............#.v#
#.#..###v#.###.#.v#
#.#............#.v#
#.......###......v#
.......#####.....>v
..#...#######...#v<
#..#...#####...#v<#
##..#...###...#v<##
###..#...#...#v<###
####.....T<<<<<####
###################
#########v#########
##.......>>>>>>>v##
#........#......>v#
#....##..#..##...v#
#....##..#..##...v#
...####..#..####.>v
...####..#..####.v<
#........#.......v#
#.#............#.v#
#.#..###v#.###.#.v#
#.#....v<<<<...#.v#
#.....v<###^<....v#
.....v<#####^<...>v
..#..v#######^..#v<
#..#.>v#####>^.#v<#
##..#.>v###>^.#v<##
###..#.>v#>^.#v<###
####....>T^<<<<####
###################		3
